books - Monarchs, Rulers, Dynasties and Kingdoms of the World - R. F. Tapsell
      - The Self-Made Tapestry: Pattern Formation in Nature - Philip Ball
      - Yanomamo: The Fierce People - Napoleon A. Chagnon
      - Category Theory in Context - Emily Riehl
      - Kronika Slovanu - Helmold z Bosau
      - Speaking Our Minds - Thom Scott-Phillips
      - Radical Enlightenment - Jonathan Israel
      - Purely Functional Data Structures - Chris Okasaki
      - How to Solve It - George Pólya
      - Children of Time - Adrian Tchaikovsky
      - Colossus - Dennis Feltham Jones
      - Notatki z podziemia - Fiodor Dostojewski
      - Type-driven Development with Idris - Edwin Brady
      - The Book of Why: The New Science of Cause and Effect - Judea Pearl & Dana Mackenzie
      - Genesis - Bernard Beckett
      - Category Theory for Programmers - Bartosz Milewski
      - Causality: Models, Reasoning, and Inference - Judea Pearl
      - Sea People: The Puzzle of Polynesia - Christina Thompson
      - The Enigma of Reason - Dan Sperber, Hugo Mercier
      - Human Diversity: Gender, Race, Class, and Genes - Charles Murray
      - Warriors and Worriers: The Survival of the Sexes - Joyce F. Benenson
      - The Strategy of Conflict - Thomas C. Schelling
      - Proofs from THE BOOK - Martin Aigner, Günter M. Ziegler
      - Feynman Lectures On Computation - Richard P. Feynman
      - Who’s #1? The Science of Rating and Ranking - Amy Langville , Carl Meyer
      - Haskell Programming from first principles - Christopher Allen, Julie Moronuki
      - The Haskell Road to Logic, Maths and Programming - Kees Doets, Jan van Eijck
      - The Little Schemer - Daniel P. Friedman, Matthias Felleisen
      - The Seasoned Schemer - Daniel P. Friedman, Matthias Felleisen
      - Artificial Intelligence for Humans, Volume 1: Fundamental Algorithms - Jeff Heaton
      - Artificial Intelligence for Humans, Volume 2: Nature-Inspired Algorithms - Jeff Heaton
      - Artificial Intelligence for Humans, Volume 3: Deep Learning and Neural Networks - Jeff Heaton
      - Felony and the Guilty Mind in Medieval England - Elizabeth Papp Kamali
      - Dejiny Libye - Eduard Gombar
      - Dynastie Świata - Przewodnik chronologiczny i genealogiczny - John E.Morby
      - Let Over Lambda - Doug Hoyte
      - Surfing Uncertainty: Prediction, Action, and the Embodied Mind - Andy Clark
      - Evil: Inside Human Violence and Cruelty - Roy Baumeister
      - The Origins of Knowledge and Imagination - Jacob Bronowski
      - The Nurture Assumption - Judith Rich Harris
      - A Profile of Mathematical Logic - Howard DeLong
      - No Two Alike - Judith Rich Harris
      - Category Theory for the Sciences - David I. Spivak
      - Type Theory and Formal Proof: An Introduction - Rob Nederpelt, Herman Geuvers
      - The Making of the Fittest: DNA and the Ultimate Forensic Record of Evolution - Sean B. Carroll
      - The Evolution of Human Sexuality - Donald Symons
      - Words On The Move: Why English Won’t, and Can’t, Sit Still (Like, Literally) - John McWhorter
      - Selected Papers on Computer Science - Donald E. Knuth
      - Structure and Interpretation of Computer Programs - Harold Abelson, Gerald Jay Sussman
      - Introduction to Algorithms - Thomas H. Cormen, Charles E. Leiserson, Ronal R. Rivest, Clifford Stein
      - The Reasoned Schemer - Daniel P. Friedman, William E. Byrd, Oleg Kiselyov
      - The Little MLer - Matthias Felleisen, Daniel P. Friedman
      - The Little Prover - Daniel P. Friedman, Carl Eastlund
      - The Little Typer - Daniel P. Friedman, David Thrane Christiansen
      - An Introduction to the Theory of Numbers - G. H. Hardy , E. M. Wright
      - Categories for the Working Mathematician - Saunders Mac Lane
      - Denotational Semantics: The Scott-Strachey Approach to Programming Language Theory - Joseph E. Stoy
      - They Thought They Were Free: The Germans, 1933-45 - Milton Mayer
      - In Praise of Forgetting : Historical Memory and Its Ironies - David Rieff
      - Information Theory and Coding - Norman Abramson
      - Topology : A Categorical Approach - Tai-Danae Bradley, Tyler Bryson, John Terilla
      - Linear and Nonlinear Programming - David G. Luenberger
      - Problems in Philosophy: The Limits of Inquiry - Colin McGinn
      - Adventures of a Mathematician - Stanisław Marcin Ulam
      - Endless Forms Most Beautiful: The New Science of Evo Devo - Sean B. Carroll
      - The Sciences of the Artificial - Herbert A. Simon
      - An Illustrated Theory of Numbers - Martin H. Weissman
      - The Insect Societies - Edward O. Wilson
      - Game Engine Black Book: Wolfenstein 3D - Fabien Sanglard
      - Game Engine Black Book: DOOM - Fabien Sanglard
      - Transactional Information Systems: Theory, Algorithms, and the Practice of Concurrency Control and Recovery - Gottfried Vossen, Gerhard Weikum
      - The Art of SQL - Stephane Faroult, Peter Robson
      - Programming in D - Ali Cehreli
      - Learning D - Michael Parker
      - Programming Pearls - Jon Bentley
      - More Programming Pearls - Jon Bentley
      - Algorithms - Robert Sedgewick, Kevin Wayne
      - A Discipline of Programming - Edsger W. Dijkstra
      - The Algortihm Design Manual - Steven S. Skiena
      - Compilers: Principles, Techniques, and Tools, Alfred V. Aho, Monica S. Lam, Ravi Sethi and Jeffrey D. Ullman
      - Combinatorial Problems and Exercises - Laszlo Lovasz
      - The Center Cannot Hold : My Journey Through Madness - Elyn R. Saks
      - Real World Haskell - Bryan O'Sullivan, John Goerzen, Donald Bruce Stewart
      - Haskell High Performance Programming - Samuli Thomasson
      - D Web Development - Kai Nacke
      - The Village Effect - Susan Pinker
      - Lying - Sam Harris
      - Proofs without Words: Exercises in Visual Thinking - Roger B. Nelsen
      - Proofs Without Words II: More Exercises in Visual Thinking - Roger B. Nelsen
      - The Implementation of Functional Programming Languages - Simon L. Peyton Jones
      - Biological Physics: Energy, Information, Life - Philip Nelson
      - The Thermodynamic Machinery of Life - Michał Kurzyński
      - Expert C Programming: Deep C Secrets - Peter Van Der Linden
      - Pure, White and Deadly - John Yudkin
      - From Logic Programming to Prolog - Krzysztof Apt
      - The Internationalists: How a Radical Plan to Outlaw War Remade the World - Oona A. Hathaway, Scott J. Shapiro
      - At Home in the Universe: The Search for the Laws of Self-Organization and Complexity - Stuart Kauffman
      - Effective Modern C++ - Scott Meyers
      - Exceptional C++ - Herb Sutter
      - More Exceptional C++ - Herb Sutter
      - Exceptional C++ Style - Herb Sutter
      - C++ Coding Standards - Herb Sutter, Andrei Alexandrescu
      - C++ Templates: The Complete Guide - David Vandevoorde, Nicolai M. Josuttis
      - The Design and Evolution of C++ - Bjarne Stroustrup
      - Interactive Theorem Proving and Program Development - Yves Bertot, Pierre Castéran
      - The Standard C Library - P.L.Plauger
      - The C Programming Language - Brian W.Kernighan, Dennis M. Ritchie
      - Hacker's Delight - Henry S. Warren
      - Compiling with Continuations - Andrew W. Appel
      - Language and Mind - Noam Chomsky
      - A Course in Number Theory and Cryptography - Neal Koblitz
      - Linguistics: An Introduction to Language and Communication - Adrian Akmajian, Ann K. Farmer, Lee Bickmore, Richard A. Demers, Robert M. Harnish
      - C: A Reference Manual - Samuel P. Harbison, Guy L. Steele Jr.
    Stanislaw Lem
                - Oblok Magellana
                - Pamietnik znaleziony w wannie
                - Doskonala proznia
                - Wielkosc urojona
                - Golem XIV
    Thorgal - wszystkie komiksy
    Wiedźmin Tom 3-8 - Andrzej Sapkowski [Karolina]
movies - The Act of Killing - Joshua Oppenheimer
       - The Look of Silence - Joshua Oppenheimer
       - Joseph Campbell and the Power of Myth
       - The Vietnam War - Ken Burns and Lynn Novick
       - The Atomic Cafe
mountains
  - tents - light tent for 1-2 people
    - Nemo Hornet 2P
  - mobile power bank with solar panels
